eng_name	fin_name	category	word_class
accident	onnettomuus	abstract_mid	noun
actress	näyttelijä	human	noun
advantage	etu	abstract_high	noun
airplane	lentokone	vehicle	noun
age	ikä	abstract_high	noun
album	albumi	text	noun
apartment	asunto	building	noun
appendix	liite	abstract_mid	noun
apple	omena	fruit	noun
application	sovellus	abstract_high	noun
army	armeija	abstract_mid	noun
artichoke	artisokka	vegetable	noun
asparagus	parsa	vegetable	noun
author	kirjailija	human	noun
axe	kirves	tool	noun
back	selkä	bodypart	noun
background	tausta	abstract_mid	noun
bacterium	bakteeri	abstract_mid	noun
ball	pallo	sport	noun
banana	banaani	fruit	noun
bean	papu	vegetable	noun
bear	karhu	animal	noun
beauty	kauneus	abstract_high	noun
bicycle	polkupyörä	vehicle	noun
blood	veri	bodypart	noun
blouse	pusero	clothing	noun
boat	vene	vehicle	noun
bomb	pommi	weapon	noun
book	kirja	tool	noun
box	laatikko	container	noun
boy	poika	human	noun
break	tauko	abstract_high	noun
bridge	silta	building	noun
broccoli	parsakaali	vegetable	noun
bronze	pronssi	material	noun
broom	luuta	tool	noun
brush	harja	tool	noun
bus	bussi	vehicle	noun
cabbage	kaali	vegetable	noun
camel	kameli	animal	noun
camp	leiri	building	noun
cannon	tykki	weapon	noun
car	auto	vehicle	noun
card	kortti	text	noun
carrot	porkkana	vegetable	noun
castle	linna	building	noun
cat	kissa	animal	noun
cauliflower	kukkakaali	vegetable	noun
celery	selleri	vegetable	noun
chair	tuoli	furniture	noun
change	muutos	abstract_high	noun
chaos	kaaos	abstract_high	noun
cherry	kirsikka	fruit	noun
child	lapsi	human	noun
church	kirkko	building	noun
cloud	pilvi	nature	noun
coat	takki	clothing	noun
comb	kampa	tool	noun
community	yhteisö	abstract_mid	noun
concert	konsertti	abstract_mid	noun
corn	maissi	vegetable	noun
cow	lehmä	animal	noun
creature	olio	abstract_mid	noun
cucumber	kurkku	vegetable	noun
daughter	tytär	human	noun
democracy	demokratia	abstract_high	noun
dimension	ulottuvuus	abstract_high	noun
dog	koira	animal	noun
donkey	aasi	animal	noun
door	ovi	furniture	noun
dream	haave	abstract_high	noun
dream	uni	abstract_mid	noun
dress	mekko	clothing	noun
drill	pora	tool	noun
duck	ankka	animal	noun
eagle	kotka	animal	noun
ear	korva	bodypart	noun
earth	maapallo	nature	noun
education	koulutus	abstract_high	noun
elephant	norsu	animal	noun
end	loppu	abstract_high	noun
engine	veturi	vehicle	noun
eruption	purkaus	abstract_mid	noun
event	tapahtuma	abstract_mid	noun
evidence	todiste	abstract_mid	noun
experience	kokemus	abstract_high	noun
experiment	koe	abstract_mid	noun
expression	ilme	abstract_mid	noun
eye	silmä	bodypart	noun
factory	tehdas	building	noun
faith	kohtalo	abstract_high	noun
father	isä	human	noun
female	naaras	abstract_mid	noun
fence	aita	building	noun
finger	sormi	bodypart	noun
fire	tuli	nature	noun
fork	haarukka	tool	noun
fox	kettu	animal	noun
freedom	vapaus	abstract_high	noun
friction	kitka	abstract_mid	noun
friend	ystävä	human	noun
fuel	polttoaine	material	noun
funding	rahoitus	abstract_high	noun
gas	kaasu	material	noun
gate	portti	building	noun
gear	vaihde	abstract_mid	noun
gene	geeni	abstract_mid	noun
giraffe	kirahvi	animal	noun
glacier	jäätikkö	nature	noun
glove	käsine	clothing	noun
goat	vuohi	animal	noun
grape	viinirypäle	fruit	noun
grapefruit	greippi	fruit	noun
group	ryhmä	abstract_mid	noun
guitar	kitara	instrument	noun
gun	ase	weapon	noun
hair	hiukset	bodypart	noun
hammer	vasara	tool	noun
hand	käsi	bodypart	noun
head	pää	bodypart	noun
helicopter	helikopteri	vehicle	noun
hike	vaellus	abstract_mid	noun
history	historia	abstract_high	noun
hoe	kuokka	tool	noun
horse	hevonen	animal	noun
hospital	sairaala	building	noun
hotel	hotelli	building	noun
hunting	metsästys	abstract_mid	noun
ideology	aate	abstract_high	noun
infection	infektio	abstract_mid	noun
inflation	inflaatio	abstract_high	noun
internet	internet	abstract_mid	noun
investment	sijoitus	abstract_high	noun
island	saari	nature	noun
jail	vankila	building	noun
judge	tuomari	human	noun
king	kuningas	human	noun
knife	puukko	tool	noun
knife	veitsi	tool	noun
brother	veli	human	noun
knowledge	tieto	abstract_high	noun
leg	jalka	bodypart	noun
legend	legenda	abstract_high	noun
lemon	sitruuna	fruit	noun
library	kirjasto	building	noun
lime	lime	fruit	noun
lion	leijona	animal	noun
lip	huuli	bodypart	noun
logic	logiikka	abstract_high	noun
magic	taika	abstract_high	noun
man	mies	human	noun
mansion	kartano	building	noun
marking	merkintä	abstract_mid	noun
material	materiaali	abstract_mid	noun
meaning	merkitys	abstract_high	noun
medium	väliaine	abstract_mid	noun
meeting	kokous	abstract_mid	noun
merit	meriitti	abstract_high	noun
metal	metalli	material	noun
meter	metri	abstract_mid	noun
missile	ohjus	weapon	noun
mittens	lapaset	clothing	noun
monastery	luostari	building	noun
money	raha	abstract_high	noun
morning	aamu	abstract_mid	noun
mother	äiti	human	noun
motor	moottori	vehicle	noun
mountain	vuori	nature	noun
mouse	hiiri	animal	noun
mouth	suu	bodypart	noun
museum	museo	building	noun
mushroom	sieni	vegetable	noun
music	musiikki	abstract_mid	noun
nature	luonto	abstract_mid	noun
nest	pesä	nature	noun
news	uutinen	abstract_high	noun
newspaper	sanomalehti	text	noun
evening	ilta	abstract_mid	noun
nose	nenä	bodypart	noun
oak	tammi	nature	noun
onion	sipuli	vegetable	noun
opinion	mielipide	abstract_high	noun
oxygen	happi	abstract_mid	noun
painting	maalaus	tool	noun
palace	palatsi	building	noun
panther	pantteri	animal	noun
paper	paperi	material	noun
parish	seurakunta	abstract_mid	noun
park	puisto	nature	noun
party	juhla	abstract_mid	noun
patient	potilas	human	noun
peach	persikka	fruit	noun
pear	päärynä	fruit	noun
phenomenon	ilmiö	abstract_high	noun
philosopher	filosofi	human	noun
physician	lääkäri	human	noun
picture	kuva	text	noun
pig	sika	animal	noun
pineapple	ananas	fruit	noun
game	leikki	abstract_mid	noun
play	näytelmä	abstract_mid	noun
player	pelaaja	human	noun
pliers	pihdit	tool	noun
poem	runo	abstract_mid	noun
police	poliisi	human	noun
politics	politiikka	abstract_high	noun
population	väestö	abstract_mid	noun
potato	peruna	vegetable	noun
power	teho	abstract_high	noun
power	valta	abstract_high	noun
pressure	paine	abstract_mid	noun
price	hinta	abstract_mid	noun
priest	pappi	human	noun
princess	prinsessa	human	noun
prisoner	vanki	human	noun
problem	ongelma	abstract_high	noun
professor	professori	human	noun
promotion	ylennys	abstract_high	noun
pumpkin	kurpitsa	vegetable	noun
quantity	määrä	abstract_high	noun
rabbit	kani	animal	noun
rake	harava	tool	noun
raspberry	vadelma	fruit	noun
reason	järki	abstract_high	noun
religion	uskonto	abstract_high	noun
reputation	maine	abstract_high	noun
review	arvio	abstract_high	noun
ring	sormus	clothing	noun
river	joki	nature	noun
rock	kallio	nature	noun
room	huone	building	noun
satellite	satelliitti	vehicle	noun
saw	saha	tool	noun
scarf	huivi	clothing	noun
school	koulu	building	noun
science	tiede	abstract_high	noun
scissors	sakset	tool	noun
sea	meri	nature	noun
sheep	lammas	animal	noun
ship	laiva	vehicle	noun
shirt	paita	clothing	noun
shoe	kenkä	clothing	noun
shovel	lapio	tool	noun
size	koko	abstract_mid	noun
skirt	hame	clothing	noun
sock	sukka	clothing	noun
soldier	sotilas	human	noun
song	laulu	abstract_mid	noun
soot	noki	nature	noun
speech	puhe	abstract_mid	noun
spoon	lusikka	tool	noun
stable	talli	building	noun
star	tähti	nature	noun
statue	patsas	building	noun
status	status	abstract_high	noun
stool	jakkara	furniture	noun
story	tarina	abstract_high	noun
strait	salmi	nature	noun
strawberry	mansikka	fruit	noun
studio	studio	building	noun
success	menestys	abstract_high	noun
sweater	villapaita	clothing	noun
sword	miekka	tool	noun
symptom	oire	abstract_mid	noun
system	järjestelmä	abstract_high	noun
table	pöytä	furniture	noun
tail	häntä	body/animal	noun
teacher	opettaja	human	noun
team	joukkue	abstract_mid	noun
temple	temppeli	building	noun
thought	ajatus	abstract_high	noun
thumb	peukalo	bodypart	noun
tiger	tiikeri	animal	noun
time	ajankohta	abstract_high	noun
timing	ajoitus	abstract_high	noun
toe	varvas	bodypart	noun
tower	torni	building	noun
train	juna	vehicle	noun
truck	rekka	vehicle	noun
tweezers	pinsetit	tool	noun
town	taajama	abstract_mid	noun
valley	laakso	nature	noun
van	pakettiauto	vehicle	noun
village	kylä	building	noun
wall	muuri	building	noun
water	vesi	nature	noun
watermelon	vesimeloni	fruit	noun
wave	aalto	nature	noun
weight	paino	abstract_mid	noun
wife	vaimo	human	noun
will	tahto	abstract_high	noun
window	ikkuna	furniture	noun
wing	siipi	body/animal	noun
wolf	susi	animal	noun
woman	nainen	human	noun
work	teos	abstract_mid	noun
youth	nuoruus	abstract_high	noun
zebra	seepra	animal	noun
