eng_name	fin_name	category	word_class
academy	akatemia	abstract_high	noun
accident	onnettomuus	abstract_mid	noun
accordion	harmonikka	instrument	noun
acorn	tammenterho	plant	noun
actress	näyttelijä	human	noun
advantage	etu	abstract_high	noun
airplane	lentokone	vehicle	noun
age	ikä	abstract_high	noun
aisle	käytävä	building	noun
album	albumi	text	noun
alcohol	alkoholi	drink	noun
alley	kuja	place	noun
alligator	alligaattori	animal	noun
almond	manteli	fruit	noun
ambulance	ambulanssi	vehicle	noun
anchor	ankkuri	tool	noun
ankle	nilkka	bodypart	noun
ant	muurahainen	insect	noun
antelope	antilooppi	animal	noun
antique	antiikki	abstract_high	noun
apartment	asunto	building	noun
ape	ihmisapina	animal	noun
appendix	liite	abstract_mid	noun
apple	omena	fruit	noun
appliance	laite	appliance	noun
application	sovellus	abstract_high	noun
apricot	aprikoosi	fruit	noun
apron	esiliina	clothing	noun
aquarium	akvaario	place	noun
arch	kaari	abstract_low	noun
arm	käsivarsi	bodypart	noun
armchair	nojatuoli	furniture	noun
armour	panssari	weapon	noun
armrest	käsinoja	furniture	noun
army	armeija	abstract_mid	noun
arrow	nuoli	tool	noun
artichoke	artisokka	vegetable	noun
ashtray	tuhkakuppi	container	noun
asparagus	parsa	vegetable	noun
asphalt	asfaltti	material	noun
aspirin	aspiriini	medicine	noun
atom	atomi	abstract_low	noun
attic	ullakko	place	noun
aubergine	munakoiso	vegetable	noun
auditorium	audiotorio	place	noun
author	kirjailija	human	noun
avenue	puistokatu	place	noun
avocado	avokado	fruit	noun
axe	kirves	tool	noun
axle	akseli	tool	noun
baby	vauva	person	noun
back	selkä	bodypart	noun
background	tausta	abstract_mid	noun
backpack	reppu	accessory	noun
bacon	pekoni	food	noun
bacterium	bakteeri	abstract_mid	noun
badge	nimikyltti	accessory	noun
bag	laukku	accessory	noun
bagel	bagel	food	noun
bagpipe	säkkipilli	instrument	noun
ball	pallo	sport	noun
balloon	ilmapallo	toy	noun
banana	banaani	fruit	noun
band	bändi	social	noun
bandage	side	medicine	noun
banjo	banjo	instrument	noun
bank	pankki	place	noun
banner	tunnus	abstract_low	noun
barge	proomu	vehicle	noun
barn	aitta	place	noun
barrel	tynnyri	container	noun
basement	kerros	place	noun
basket	kori	sport	noun
bath	kylpy	abstract_low	noun
bathrobe	kylpytakki	clothing	noun
bathtub	kylpyamme	furniture	noun
baton	pamppu	weapon	noun
bay	lahti	nature	noun
bayonet	pistin	weapon	noun
bazooka	sinko	weapon	noun
beach	uimaranta	nature	noun
beak	nokka	bodypart	noun
bean	papu	vegetable	noun
bear	karhu	animal	noun
beard	parta	bodypart	noun
beauty	kauneus	abstract_high	noun
beaver	majava	animal	noun
bed	sänky	furniture	noun
bedroom	makuuhuone	place	noun
bee	mehiläinen	insect	noun
beef	naudanliha	food	noun
beehive	mehiläispesä	nature	noun
beer	olut	drink	noun
beet	juurikas	vegetable	noun
beetle	kovakuoriainen	insect	noun
bell	soittokello	instrument	noun
bellows	palje	tool	noun
belly	maha	bodypart	noun
belt	vyö	clothing	noun
bench	penkki	furniture	noun
berry	marja	fruit	noun
beverage	virvoitusjuoma	drink	noun
bible	raamattu	text	noun
bicycle	polkupyörä	vehicle	noun
bikini	bikini	clothing	noun
billboard	mainostaulu	text	noun
bin	roskakori	furniture	noun
birch	koivu	plant	noun
bird	lintu	bird	noun
biscuit	keksi	food	noun
bison	biisoni	animal	noun
blackbird	mustarastas	bird	noun
blade	terä	tool	noun
blanket	huopa	artifact	noun
blender	tehosekoitin	appliance	noun
blood	veri	bodypart	noun
blossom	kukinta	plant	noun
blouse	pusero	clothing	noun
blueberry	mustikka	fruit	noun
bluebird	sinikka	bird	noun
bluejay	sinitöyhtönärhi	bird	noun
blackboard	liitutaulu	furniture	noun
board	taulu	furniture	noun
boat	vene	vehicle	noun
body	ruumis	bodypart	noun
bolts	pultti	tool	noun
bomb	pommi	weapon	noun
bone	luu	bodypart	noun
book	kirja	tool	noun
bookcase	kirjahylly	furniture	noun
boomerang	bumerangi	sport	noun
boot	saapas	clothing	noun
bottle	pullo	container	noun
boulder	lohkare	nature	noun
bouquet	kukkakimppu	artifact	noun
bowl	kulho	container	noun
box	laatikko	container	noun
boy	poika	human	noun
bra	rintaliivit	clothing	noun
bracelet	rannekoru	clothing	noun
brain	aivot	bodypart	noun
brake	jarru	tool	noun
branch	haara	abstract_high	noun
brandy	brandy	drink	noun
bread	leipä	food	noun
break	tauko	abstract_high	noun
breakfast	aamiainen	food	noun
breast	rinta	bodypart	noun
breath	hengitys	abstract_low	noun
breeze	tuulahdus	nature	noun
brick	tiili	artifact	noun
bridge	silta	building	noun
briefcase	salkku	accessory	noun
broccoli	parsakaali	vegetable	noun
brochure	mainos	text	noun
bronze	pronssi	material	noun
broom	luuta	tool	noun
brush	harja	tool	noun
brussel_sprouts	ruusukaali	vegetable	noun
bubble	kupla	abstract_low	noun
bucket	ämpäri	container	noun
buckle	solki	clothing	noun
budgie	undulaatti	bird	noun
buffalo	puhveli	animal	noun
buggy	vaunut	vehicle	noun
building	rakennus	place	noun
bull	sonni	animal	noun
bulldozer	puskutraktori	vehicle	noun
bullet	luoti	weapon	noun
bumper	puskuri	artifact	noun
bungalow	bungalow	place	noun
bureau	virasto	place	noun
burner	poltin	appliance	noun
bus	bussi	vehicle	noun
bush	puska	plant	noun
butter	voi	food	noun
buttercup	leinikki	plant	noun
butterfly	perhonen	insect	noun
buttocks	pakara	bodypart	noun
button	nappi	tool	noun
buzzard	haukka	bird	noun
cabbage	kaali	vegetable	noun
cabin	hytti	place	noun
cabinet	vaatehuone	place	noun
cactus	kaktus	plant	noun
cafe	kahvila	place	noun
cage	häkki	place	noun
cake	kakku	food	noun
calculator	laskin	appliance	noun
calf	vasikka	animal	noun
camel	kameli	animal	noun
camera	kamera	appliance	noun
camisole	aluspaita	clothing	noun
camp	leiri	building	noun
can_opener	tölkinavaaja	tool	noun
canal	kanaali	place	noun
canary	kanarialintu	bird	noun
cancer	syöpä	medicine	noun
candle	kynttilä	artifact	noun
candy	karkki	food	noun
cannon	tykki	weapon	noun
canoe	kanootti	vehicle	noun
cantaloupe	verkkomeloni	fruit	noun
canteen	kantiini	place	noun
capitol	capitol	place	noun
car	auto	vehicle	noun
caravan	matkailuauto	vehicle	noun
card	kortti	text	noun
caribou	karibu	animal	noun
carnation	tarhaneilikka	plant	noun
carp	karppi	waterlife	noun
carpet	kokolattiamatto	furniture	noun
carriage	vaunu	vehicle	noun
carrot	porkkana	vegetable	noun
cart	ostoskärry	vehicle	noun
carton	kartonki	tool	noun
cash	käteinen	abstract_low	noun
cast	kipsi	medicine	noun
castanets	kastanjetit	instrument	noun
castle	linna	building	noun
cat	kissa	animal	noun
catalogue	katalogi	text	noun
catapault	katapultti	weapon	noun
caterpillar	perhosentoukka	insect	noun
catfish	monni	waterlife	noun
cathedral	katedraali	place	noun
cattle	karja	animal	noun
cauliflower	kukkakaali	vegetable	noun
cave	luola	nature	noun
cd	cd	artifact	noun
cedar	setri	plant	noun
ceiling	sisäkatto	furniture	noun
celery	selleri	vegetable	noun
cellar	kellari	place	noun
cello	sello	instrument	noun
cellphone	kännykkä	appliance	noun
cement	sementti	material	noun
cemetary	hautausmaa	place	noun
centipede	juoksujalkainen	insect	noun
cereal	murot	food	noun
certificate	sertifikaatti	abstract_low	noun
chain	ketju	tool	noun
chainsaw	moottorisaha	tool	noun
chair	tuoli	furniture	noun
chalk	liitu	tool	noun
champagne	shampanja	drink	noun
chandelier	kattokruunu	furniture	noun
change	muutos	abstract_high	noun
channel	kanava	abstract_low	noun
chaos	kaaos	abstract_high	noun
chapel	kappeli	place	noun
cheek	poski	bodypart	noun
cheese	juusto	food	noun
cheetah	gepardi	animal	noun
cherry	kirsikka	fruit	noun
chest_of_drawers	lipasto	furniture	noun
chestnut	kastanja	plant	noun
chickadee	tiainen	bird	noun
chicken	kananpoika	bird	noun
child	lapsi	human	noun
chimney	savupiippu	furniture	noun
chimp	simpanssi	animal	noun
chin	leuka	bodypart	noun
chip	siru	artifact	noun
chipmunk	maaorava	animal	noun
chisel	taltta	tool	noun
chocolate	suklaa	food	noun
chopsticks	syömäpuikot	tool	noun
church	kirkko	building	noun
cider	siideri	food	noun
cigar	sikari	food	noun
cigarette	savuke	food	noun
cinnamon	kaneli	food	noun
circus	sirkus	social	noun
city	kaupunki	place	noun
clam	simpukka	waterlife	noun
clamp	puristin	tool	noun
clarinet	klarinetti	instrument	noun
cliff	jyrkänne	nature	noun
clipboard	leikepöytä	tool	noun
clock	kello	appliance	noun
closet	komero	furniture	noun
cloth	kangas	material	noun
clothes	vaatteet	clothing	noun
clothing	vaatetus	clothing	noun
cloud	pilvi	nature	noun
clover	apila	plant	noun
club	klubi	social	noun
coach	linja-auto	vehicle	noun
coat	takki	clothing	noun
coast	rannikko	nature	noun
cockerel	kukonpoika	bird	noun
cockpit	ohjaamo	place	noun
cockroach	torakka	insect	noun
cocktail	cocktail	drink	noun
coconut	kookos	fruit	noun
cod	turska	waterlife	noun
codeine	kodeiini	medicine	noun
coffee	kahvi	food	noun
coffee_machine	kahvinkeitin	appliance	noun
coffin	arkku	container	noun
coin	kolikko	artifact	noun
cola	kola	drink	noun
colander	lävikkö	tool	noun
collar	kaulus	clothing	noun
college	korkeakoulu	place	noun
column	sarake	abstract_low	noun
comb	kampa	tool	noun
community	yhteisö	abstract_mid	noun
computer	tietokone	appliance	noun
concert	konsertti	abstract_mid	noun
continent	maanosa	place	noun
cookie	cookie	food	noun
cord	kaapeli	appliance	noun
cork	korkki	artifact	noun
corkscrew	korkkiruuvi	tool	noun
corn	maissi	vegetable	noun
corridor	eteinen	place	noun
cottage	mökki	place	noun
cotton	puuvilla	material	noun
couch	sohva	furniture	noun
cougar	puuma	animal	noun
countertop	keittiötaso	furniture	noun
courgette	kesäkurpitsa	vegetable	noun
court	oikeus	place	noun
cow	lehmä	animal	noun
coyote	kojootti	animal	noun
crab	taskurapu	waterlife	noun
cradle	kehto	furniture	noun
cranberry	karpalo	fruit	noun
crayfish	rapu	waterlife	noun
crayon	väriliitu	toy	noun
cream	kerma	food	noun
creature	olio	abstract_mid	noun
cricket	laulukaskas	insect	noun
crocodile	krokotiili	animal	noun
crossbow	varsijousi	weapon	noun
crow	varis	bird	noun
crowbar	sorkkarauta	tool	noun
crowd	ihmisjoukko	social	noun
crown	kruunu	accessory	noun
crumb	muru	food	noun
crystal	kristalli	material	noun
cucumber	kurkku	vegetable	noun
cup	kuppi	tool	noun
cupboard	kaappi	furniture	noun
curb	reunakiveys	artifact	noun
currant	herukka	fruit	noun
curtains	verhot	furniture	noun
cushion	sohvatyyny	furniture	noun
cutting_board	leikkuulauta	tool	noun
cymbal	symbaali	instrument	noun
daffodil	narsissi	plant	noun
dagger	tikari	weapon	noun
daisy	päivänkakkara	plant	noun
dance	tanssi	sport	noun
dandelion	voikukka	plant	noun
dandruff	hilse	medicine	noun
dates	taateli	fruit	noun
daughter	tytär	human	noun
deck	pakka	toy	noun
deckchair	kansituoli	furniture	noun
deer	kauris	animal	noun
democracy	demokratia	abstract_high	noun
dent	lommo	abstract_low	noun
deodorant	deodorantti	medicine	noun
desk	työpöytä	furniture	noun
diamond	timantti	material	noun
diaper	vaippa	medicine	noun
dice	nopat	toy	noun
dictionary	sanakirja	text	noun
dime	kymmensenttinen	artifact	noun
dimension	ulottuvuus	abstract_high	noun
dinghy	jolla	vehicle	noun
dinner	päivällinen	food	noun
dinosaur	dinosaurus	animal	noun
dirt	lika	material	noun
disease	tauti	medicine	noun
dish	astia	tool	noun
dishwasher	tiskikone	appliance	noun
disinfectant	desinfiointiaine	medicine	noun
ditch	oja	place	noun
dock	telakka	place	noun
dog	koira	animal	noun
doll	nukke	toy	noun
dollar	dollari	abstract_low	noun
dolphin	delfiini	waterlife	noun
dome	kupoli	building	noun
donkey	aasi	animal	noun
door	ovi	furniture	noun
doorknob	ovenkahva	artifact	noun
doorway	oviaukko	furniture	noun
dot	täplä	abstract_low	noun
doughnut	donitsi	food	noun
dove	kyyhky	bird	noun
dragonfly	sudenkorento	insect	noun
drain	lattiakaivo	furniture	noun
drapes	verhot	furniture	noun
dream	uni	abstract_mid	noun
dress	mekko	clothing	noun
dresser	astiakaappi	furniture	noun
dressing gown	aamutakki	clothing	noun
drill	pora	tool	noun
driveway	ajotie	place	noun
drug	huume	medicine	noun
drum	rumpu	instrument	noun
duck	ankka	animal	noun
dumpster	jäteastia	container	noun
dunebuggy	rantamönkijä	vehicle	noun
dust	pöly	material	noun
dustpan	rikkalapio	tool	noun
eagle	kotka	animal	noun
ear	korva	bodypart	noun
earmuffs	kuulonsuojaimet	accessory	noun
earphones	kuulokkeet	appliance	noun
earplugs	korvatulpat	accessory	noun
earring	korvakoru	accessory	noun
earth	maapallo	nature	noun
earthworm	kastemadot	insect	noun
education	koulutus	abstract_high	noun
eel	ankerias	waterlife	noun
egg	muna	food	noun
elbow	kyynärpää	bodypart	noun
elephant	norsu	animal	noun
elevator	hissi	vehicle	noun
elk	vapiti	animal	noun
elm	jalava	plant	noun
emerald	smaragdi	material	noun
emu	emu	bird	noun
encyclopaedia	tietosanakirja	text	noun
end	loppu	abstract_high	noun
engine	veturi	vehicle	noun
entrance	sisäänkäynti	furniture	noun
envelope	kirjekuori	text	noun
eruption	purkaus	abstract_mid	noun
escalator	liukuportaat	vehicle	noun
essay	essee	text	noun
eucalyptus	eukalyptus	plant	noun
event	tapahtuma	abstract_mid	noun
evidence	todiste	abstract_mid	noun
experience	kokemus	abstract_high	noun
experiment	koe	abstract_mid	noun
expression	ilme	abstract_mid	noun
eye	silmä	bodypart	noun
eyebrow	kulmakarva	bodypart	noun
eyelash	silmäripsi	bodypart	noun
fabric	tekstiili	material	noun
face	kasvot	bodypart	noun
factory	tehdas	building	noun
faith	kohtalo	abstract_high	noun
falcon	jalohaukka	bird	noun
fan	tuuletin	appliance	noun
farm	maatila	place	noun
fat	rasva	medicine	noun
father	isä	human	noun
faucet	kraana	furniture	noun
fawn	vasa	animal	noun
feather	höyhen	material	noun
feet	jalkaterät	bodypart	noun
female	naaras	abstract_mid	noun
fence	aita	building	noun
fern	saniainen	plant	noun
ferry	autolautta	vehicle	noun
file	tiedosto	artifact	noun
film	filmi	text	noun
finch	peippo	bird	noun
finger	sormi	bodypart	noun
fingernail	sormenkynsi	bodypart	noun
fir	jalokuusi	plant	noun
fire	tuli	nature	noun
fireplace	tulisija	furniture	noun
fish	kala	waterlife	noun
flag	lippu	artifact	noun
flagpole	lipputanko	artifact	noun
flamingo	flamingo	bird	noun
flannel	flanelli	material	noun
flashlight	taskulamppu	appliance	noun
flea	kirppu	insect	noun
flip-flops	varvassandaalit	clothing	noun
floor	lattia	furniture	noun
floss	hammaslanka	artifact	noun
flounder	kampela	waterlife	noun
flour	jauho	food	noun
flower	kukka	plant	noun
flute	huilu	instrument	noun
fog	sumu	nature	noun
food	ruoka	food	noun
foot	jalkaterä	bodypart	noun
football	jalkapallo	sport	noun
forehead	otsa	bodypart	noun
forest	metsä	nature	noun
fork	haarukka	tool	noun
fox	kettu	animal	noun
frame	kehys	artifact	noun
freckles	pisamat	bodypart	noun
freedom	vapaus	abstract_high	noun
freezer	pakastin	appliance	noun
french horn	käyrätorvi	instrument	noun
friction	kitka	abstract_mid	noun
friend	ystävä	human	noun
fries	ranskanperunat	food	noun
frisbee	frisbee	sport	noun
frog	sammakko	animal	noun
fruit	hedelmä	fruit	noun
fudge	kinuski	food	noun
fuel	polttoaine	material	noun
funding	rahoitus	abstract_high	noun
fur	turkki	clothing	noun
furniture	huonekalu	furniture	noun
gallery	galleria	place	noun
gallon	gallona	abstract_low	noun
gang	jengi	social	noun
garage	autotalli	place	noun
garbage	jäte	material	noun
garden	puutarha	place	noun
garlic	valkosipuli	vegetable	noun
gas	kaasu	material	noun
gate	portti	building	noun
gazelle	gaselli	animal	noun
gear	vaihde	abstract_mid	noun
gene	geeni	abstract_mid	noun
geranium	kurjenpolvi	plant	noun
gerbil	gerbiili	animal	noun
gherkin	etikkakurkku	food	noun
ghost	haamu	abstract_high	noun
gift	lahja	abstract_low	noun
gin	gini	drink	noun
giraffe	kirahvi	animal	noun
girl	tyttö	person	noun
glacier	jäätikkö	nature	noun
glass	lasi	material	noun
glider	riippuliidin	vehicle	noun
glove	käsine	clothing	noun
glue	liima	material	noun
goat	vuohi	animal	noun
goblet	pikari	container	noun
goggles	suojalasit	clothing	noun
gold	kulta	material	noun
goldfish	kultakala	waterlife	noun
golf	golf	sport	noun
gong	gongi	instrument	noun
goose	hanhi	bird	noun
gopher	taskurotta	animal	noun
gorilla	gorilla	animal	noun
gown	kaapu	clothing	noun
grape	viinirypäle	fruit	noun
grapefruit	greippi	fruit	noun
graph	kuvaaja	abstract_high	noun
grass	ruoho	plant	noun
grasshopper	heinäsirkka	insect	noun
grater	raastin	tool	noun
grave	hauta	place	noun
gravel	sora	material	noun
gravy	paistinkastike	food	noun
greenhouse	kasvihuone	place	noun
greeting card	onnittelukortti	text	noun
grenade	kranaatti	weapon	noun
groin	nivuset	bodypart	noun
ground	maanpinta	nature	noun
groundhog	metsämurmeli	animal	noun
group	ryhmä	abstract_mid	noun
guardrail	suojakaide	furniture	noun
guinea pig	marsu	animal	noun
guitar	kitara	instrument	noun
gum	kumi	material	noun
gun	ase	weapon	noun
guppy	miljoonakala	waterlife	noun
gym	kuntosali	place	noun
haddock	kolja	waterlife	noun
hair	hiukset	bodypart	noun
hall	halli	place	noun
ham	kinkku	food	noun
hamburger	hampurilainen	food	noun
hammer	vasara	tool	noun
hamster	hamsteri	animal	noun
hand	käsi	bodypart	noun
handbag	käsilaukku	accessory	noun
handkerchief	nenäliina	accessory	noun
handle	kahva	tool	noun
handrail	kaide	furniture	noun
harbour	satama	place	noun
hare	jänis	animal	noun
harmonica	huuliharppu	instrument	noun
harp	harppu	instrument	noun
harpoon	harppuuna	weapon	noun
harpsichord	cembalo	instrument	noun
hat	hattu	clothing	noun
hatchet	retkikirves	tool	noun
hawk	haukka	bird	noun
hay	heinä	plant	noun
head	pää	bodypart	noun
headlight	ajovalo	abstract_low	noun
heart	sydän	bodypart	noun
hedge	pensasaita	building	noun
hedgehog	siili	animal	noun
heel	kantapää	bodypart	noun
helicopter	helikopteri	vehicle	noun
helmet	kypärä	accessory	noun
hen	kana	bird	noun
herb	yrtti	plant	noun
heron	harmaahaikara	bird	noun
herring	silli	waterlife	noun
highway	valtatie	place	noun
hike	vaellus	abstract_mid	noun
hill	kukkula	nature	noun
hippo	virtahepo	animal	noun
history	historia	abstract_high	noun
hockey	jääkiekko	sport	noun
hoe	kuokka	tool	noun
hog	karju	animal	noun
hole	reikä	abstract_low	noun
home	koti	place	noun
honey	hunaja	food	noun
honeydew	hunajameloni	fruit	noun
honeymoon	kuherruskuukausi	abstract_high	noun
hood	huppu	clothing	noun
hook	koukku	tool	noun
horn	sarvi	bodypart	noun
hornet	herhiläinen	insect	noun
horse	hevonen	animal	noun
hospital	sairaala	building	noun
hotel	hotelli	building	noun
house	talo	place	noun
houseboat	asuntolaiva	vehicle	noun
housefly	huonekärpänen	insect	noun
human	ihminen	person	noun
hummingbird	kolibri	bird	noun
hunting	metsästys	abstract_mid	noun
husband	aviomies	person	noun
hut	maja	place	noun
hutch	pöytätaso	furniture	noun
hyacinth	hyasintti	plant	noun
hydrant	vesiposti	artifact	noun
hyena	hyeena	animal	noun
ibuprofen	ibuprofeeni	medicine	noun
ice	jää	material	noun
ice cream	jäätelö	food	noun
iceberg	jäävuori	nature	noun
ideology	aate	abstract_high	noun
igloo	iglu	place	noun
iguana	leguaani	animal	noun
infection	infektio	abstract_mid	noun
inflation	inflaatio	abstract_high	noun
ink	muste	material	noun
inn	majatalo	place	noun
insect	hyönteinen	insect	noun
internet	internet	abstract_mid	noun
investment	sijoitus	abstract_high	noun
iPod	iPod	appliance	noun
iris	värikalvo	bodypart	noun
iron	rauta	material	noun
island	saari	nature	noun
ivy	muratti	plant	noun
jacket	pikkutakki	clothing	noun
jail	vankila	building	noun
jam	hillo	food	noun
jar	purkki	container	noun
jaw	leukaluu	bodypart	noun
jeans	farkut	clothing	noun
jeep	jeeppi	vehicle	noun
jelly	hyytelö	food	noun
jellyfish	meduusa	waterlife	noun
jersey	neulepaita	clothing	noun
jet	suihkukone	vehicle	noun
jewel	jalokivi	artifact	noun
journal	päiväkirja	text	noun
judge	tuomari	human	noun
jug	kannu	container	noun
juice	mehu	drink	noun
kangaroo	kenguru	animal	noun
kayak	kajakki	vehicle	noun
keg	oluttynnyri	container	noun
kernel	ydin	plant	noun
ketchup	ketsuppi	food	noun
kettle	teepannu	container	noun
key	avain	tool	noun
kid	muksu	person	noun
kilt	kiltti	clothing	noun
king	kuningas	human	noun
kingfisher	kuningaskalastaja	bird	noun
kitchen	keittiö	place	noun
kitchen_scales	keittiövaaka	appliance	noun
kite	leija	toy	noun
kitten	kissanpentu	animal	noun
kiwi	kiivi	fruit	noun
knee	polvi	bodypart	noun
knife	veitsi	tool	noun
brother	veli	human	noun
knob	nuppi	tool	noun
knowledge	tieto	abstract_high	noun
knuckle	rystynen	bodypart	noun
koala	koala	animal	noun
ladder	tikapuut	tool	noun
ladle	kauha	tool	noun
ladybug	leppäkerttu	insect	noun
lake	järvi	nature	noun
lamb	karitsa	animal	noun
lamp	valaisin	furniture	noun
land_rover	land rover	vehicle	noun
lane	väylä	place	noun
lantern	lyhty	artifact	noun
lap	syli	bodypart	noun
laptop	kannettava tietokone	appliance	noun
laundry	pyykki	clothing	noun
lawn	nurmikko	nature	noun
lawnmower	ruohonleikkuri	vehicle	noun
leaf	lehti	plant	noun
leek	purjo	vegetable	noun
leg	jalka	bodypart	noun
legend	legenda	abstract_high	noun
lemon	sitruuna	fruit	noun
lemonade	limonadi	drink	noun
leopard	leopardi	animal	noun
leotard	jumppapuku	clothing	noun
letter	kirje	text	noun
lettuce	lehtisalaatti	vegetable	noun
level	taso	abstract_high	noun
lever	vipu	tool	noun
library	kirjasto	building	noun
lightbulb	lamppu	artifact	noun
lightning	salama	nature	noun
lily	lilja	plant	noun
limb	raaja	bodypart	noun
lime	lime	fruit	noun
limousine	limusiini	vehicle	noun
linen	liinavaatteet	artifact	noun
lint	nöyhtä	material	noun
lion	leijona	animal	noun
lip	huuli	bodypart	noun
lipstick	huulipuna	clothing	noun
liquid	neste	material	noun
liquor	viina	drink	noun
liver	maksa	bodypart	noun
livingroom	olohuone	place	noun
lizard	lisko	animal	noun
llama	laama	animal	noun
lobster	hummeri	waterlife	noun
lock	lukko	tool	noun
locker	lokero	furniture	noun
locust	sirkka	insect	noun
logic	logiikka	abstract_high	noun
lorry	kuorma-auto	vehicle	noun
lotion	voide	medicine	noun
loudspeaker	kaiutin	appliance	noun
lunch	lounas	food	noun
lunchbox	eväslaukku	container	noun
lung	keuhko	bodypart	noun
macaroni	makaroni	food	noun
machete	viidakkoveitsi	weapon	noun
mackerel	makrilli	waterlife	noun
magazine	aikakausilehti	text	noun
magic	taika	abstract_high	noun
magnet	magneetti	artifact	noun
magpie	harakka	bird	noun
mail	posti	artifact	noun
mailbox	postilaatikko	container	noun
male	uros	abstract_low	noun
man	mies	human	noun
mandarin	mandariini	fruit	noun
mango	mango	fruit	noun
mannequin	mallinukke	artifact	noun
mansion	kartano	building	noun
map	kartta	artifact	noun
maple	vaahtera	plant	noun
marble	marmori	material	noun
marigold	kehäkukka	plant	noun
market	ruokakauppa	place	noun
marking	merkintä	abstract_mid	noun
mask	naamio	clothing	noun
mat	ovimatto	furniture	noun
material	materiaali	abstract_mid	noun
mattress	patja	furniture	noun
mayonnaise	majoneesi	food	noun
meadow	niitty	nature	noun
meal	ateria	food	noun
meaning	merkitys	abstract_high	noun
measles	tuhkarokko	medicine	noun
meatballs	lihapullat	food	noun
medal	mitali	accessory	noun
medicine	lääke	medicine	noun
medium	väliaine	abstract_mid	noun
meeting	kokous	abstract_mid	noun
melon	meloni	fruit	noun
menu	ruokalista	text	noun
merit	meriitti	abstract_high	noun
metal	metalli	material	noun
meteor	meteori	nature	noun
meter	metri	abstract_mid	noun
microphone	mikrofoni	appliance	noun
microscope	mikroskooppi	appliance	noun
microwave	mikroaaltouuni	appliance	noun
milk	maito	drink	noun
milkshake	pirtelö	drink	noun
millipede	tuhatjalkainen	insect	noun
minivan	tila-auto	vehicle	noun
mink	minkki	animal	noun
mink_coat	minkkiturkki	clothing	noun
minnow	mutu	waterlife	noun
mirror	peili	furniture	noun
missile	ohjus	weapon	noun
mist	utu	nature	noun
mitt	hanska	clothing	noun
mitten	tumppu	clothing	noun
mittens	lapaset	clothing	noun
mixer	vatkain	appliance	noun
moccasins	mokkasiinit	clothing	noun
mole	myyrä	animal	noun
monastery	luostari	building	noun
money	raha	abstract_high	noun
monkey	apina	animal	noun
moon	kuu	nature	noun
moose	hirvi	animal	noun
mop	moppi	tool	noun
moped	mopo	vehicle	noun
morning	aamu	abstract_mid	noun
mosquito	hyttynen	insect	noun
moss	sammal	plant	noun
moth	koi	insect	noun
mother	äiti	human	noun
motor	moottori	vehicle	noun
motorcycle	moottoripyörä	vehicle	noun
mountain	vuori	nature	noun
mouse	hiiri	animal	noun
mouse_computer	tietokonehiiri	appliance	noun
mouth	suu	bodypart	noun
mouthpiece	suukappale	artifact	noun
mud	muta	nature	noun
muffler	vaimennin	tool	noun
mug	muki	container	noun
muscle	lihas	bodypart	noun
museum	museo	building	noun
mushroom	sieni	vegetable	noun
music	musiikki	abstract_mid	noun
mussel	sinisimpukka	waterlife	noun
mustard	sinappi	food	noun
muzzle	kuono	bodypart	noun
nail	kynsi	tool	noun
nail_polish	kynsilakka	clothing	noun
napkin	lautasliina	artifact	noun
nature	luonto	abstract_mid	noun
neck	kaula	bodypart	noun
necklace	kaulakoru	clothing	noun
necktie	kravatti	clothing	noun
nectarine	nektariini	fruit	noun
needle	neula	tool	noun
nerve	hermo	bodypart	noun
nest	pesä	nature	noun
net	verkko	artifact	noun
news	uutinen	abstract_high	noun
newspaper	sanomalehti	text	noun
nickel	viisisenttinen	artifact	noun
evening	ilta	abstract_mid	noun
nightgown	yöpaita	clothing	noun
nightingale	satakieli	bird	noun
noodle	nuudeli	food	noun
nose	nenä	bodypart	noun
note	muistilappu	text	noun
notebook	muistikirja	text	noun
novel	romaani	text	noun
nut	pähkinä	fruit	noun
oak	tammi	nature	noun
oar	airo	tool	noun
oatmeal	puuro	food	noun
ocean	valtameri	nature	noun
octopus	mustekala	waterlife	noun
office	toimisto	place	noun
oil	öljy	material	noun
oil_tanker	öljytankkeri	vehicle	noun
olive	oliivi	fruit	noun
onion	sipuli	vegetable	noun
opinion	mielipide	abstract_high	noun
orange	appelsiini	fruit	noun
orchid	orkidea	plant	noun
organ	urut	instrument	noun
oriole	kuhankeittäjä	bird	noun
ostrich	strutsi	bird	noun
otter	saukko	animal	noun
outfit	asu	clothing	noun
oven	uuni	appliance	noun
owl	pöllö	bird	noun
ox	härkä	animal	noun
oxygen	happi	abstract_mid	noun
oyster	osteri	waterlife	noun
package	pakkaus	container	noun
page	sivu	text	noun
paintbrush	pensseli	tool	noun
painting	maalaus	tool	noun
palace	palatsi	building	noun
pamphlet	pamfletti	abstract_high	noun
pan	pannu	container	noun
pancake	pannukakku	food	noun
pansy	orvokki	plant	noun
panther	pantteri	animal	noun
panties	pikkuhousut	clothing	noun
paper	paperi	material	noun
parade	kulkue	social	noun
parakeet	aratti	bird	noun
parcel	paketti	container	noun
parish	seurakunta	abstract_mid	noun
park	puisto	nature	noun
parka	anorakki	clothing	noun
parrot	papukaija	bird	noun
parsley	persilja	vegetable	noun
partridge	peltopyy	bird	noun
party	juhla	abstract_mid	noun
pasta	pasta	food	noun
paste	tahna	material	noun
patient	potilas	human	noun
pawn	pelinappula	toy	noun
pea	herne	vegetable	noun
peach	persikka	fruit	noun
peacock	riikinkukko	bird	noun
peanut	maapähkinä	fruit	noun
pear	päärynä	fruit	noun
pearl	helmi	accessory	noun
peeler	kuorija	tool	noun
peg	tappi	tool	noun
pelican	pelikaani	bird	noun
pen	kynä	tool	noun
pencil	lyijykynä	tool	noun
penguin	pingviini	bird	noun
penknife	linkkuveitsi	weapon	noun
pennicillin	penisilliini	medicine	noun
penny	penni	artifact	noun
pepper	pippuri	food	noun
pepperoni	pepperoni	food	noun
perch	orsi	artifact	noun
perfume	hajuvesi	clothing	noun
person	henkilö	person	noun
pet	lemmikki	animal	noun
pheasant	fasaani	bird	noun
phenomenon	ilmiö	abstract_high	noun
philosopher	filosofi	human	noun
phone	puhelin	appliance	noun
phonebook	puhelinluettelo	text	noun
photograph	valokuva	text	noun
physician	lääkäri	human	noun
piano	piano	instrument	noun
pickle	suolakurkku	food	noun
pickup	pickup	vehicle	noun
picture	kuva	text	noun
pie	piirakka	food	noun
pier	laituri	place	noun
pig	sika	animal	noun
pigeon	pulu	bird	noun
pill	pilleri	medicine	noun
pillow	tyyny	furniture	noun
pimple	finni	medicine	noun
pin	nasta	tool	noun
pineapple	ananas	fruit	noun
pine	mänty	plant	noun
pint	tuoppi	container	noun
pistol	pistooli	weapon	noun
pit	kuoppa	nature	noun
pizza	pitsa	food	noun
plane	höylä	tool	noun
planet	planeetta	nature	noun
plank	lankku	material	noun
plate	lautanen	tool	noun
platform	lava	place	noun
platter	vati	tool	noun
platypus	vesinokkaeläin	animal	noun
game	leikki	abstract_mid	noun
play	näytelmä	abstract_mid	noun
player	pelaaja	human	noun
playground	leikkikenttä	place	noun
pliers	pihdit	tool	noun
plough	lumiaura	vehicle	noun
plug	pistoke	tool	noun
plum	luumu	fruit	noun
pocket	tasku	clothing	noun
pocketbook	taskukirja	text	noun
poem	runo	abstract_mid	noun
poison	myrkky	medicine	noun
pole	tanko	artifact	noun
police	poliisi	human	noun
politics	politiikka	abstract_high	noun
pollen	siitepöly	nature	noun
pond	lampi	nature	noun
pony	poni	animal	noun
pool	uima-allas	place	noun
popcorn	popcorn	food	noun
poppy	unikko	plant	noun
population	väestö	abstract_mid	noun
porcupine	piikkisika	animal	noun
porsche	porsche	vehicle	noun
poster	juliste	text	noun
pot	ruukku	container	noun
potato	peruna	vegetable	noun
potholes	montut	nature	noun
powder	jauhe	material	noun
power	teho	abstract_high	noun
power	valta	abstract_high	noun
pram	lastenvaunu	vehicle	noun
prawn	katkarapu	waterlife	noun
pressure	paine	abstract_mid	noun
price	hinta	abstract_mid	noun
priest	pappi	human	noun
princess	prinsessa	human	noun
prisoner	vanki	human	noun
problem	ongelma	abstract_high	noun
professor	professori	human	noun
projector	projektori	appliance	noun
promotion	ylennys	abstract_high	noun
propeller	propelli	appliance	noun
prune	luumu	fruit	noun
pudding	jälkiruoka	food	noun
puddle	lätäkkö	nature	noun
pumpkin	kurpitsa	vegetable	noun
pupil	oppilas	person	noun
puppet	käsinukke	toy	noun
puppy	koiranpentu	animal	noun
purse	kukkaro	accessory	noun
pyjamas	pyjama	clothing	noun
pyramid	pyramidi	place	noun
python	pytonkäärme	animal	noun
quantity	määrä	abstract_high	noun
quart	vartti	abstract_high	noun
quarter	neljäsosa	abstract_high	noun
quilt	täkki	clothing	noun
rabbit	kani	animal	noun
raccoon	pesukarhu	animal	noun
racetrack	ravirata	place	noun
racket	maila	sport	noun
radio	radio	appliance	noun
radish	retiisi	vegetable	noun
raft	lautta	vehicle	noun
railroad	rautatie	place	noun
raindrops	sadepisarat	nature	noun
rainstorm	rankkasade	nature	noun
raisin	rusina	food	noun
rake	harava	tool	noun
rash	ihottuma	medicine	noun
raspberry	vadelma	fruit	noun
rat	rotta	animal	noun
rattlesnake	kalkkarokäärme	animal	noun
raven	korppi	bird	noun
ravine	rotko	nature	noun
razor	partahöylä	tool	noun
reason	järki	abstract_high	noun
receipt	kuitti	text	noun
recorder	nauhuri	appliance	noun
refrigerator	jääkaappi	appliance	noun
religion	uskonto	abstract_high	noun
reptile	matelija	animal	noun
reputation	maine	abstract_high	noun
resort	lomakohde	place	noun
restaurant	ravintola	place	noun
review	arvio	abstract_high	noun
revolver	revolveri	weapon	noun
rhino	sarvikuono	animal	noun
rhubarb	raparperi	fruit	noun
rib	kylkiluu	bodypart	noun
ribbon	nauha	accessory	noun
rice	riisi	food	noun
rifle	kivääri	weapon	noun
ring	sormus	clothing	noun
river	joki	nature	noun
road	tie	building	noun
robe	leninki	clothing	noun
robin	punarinta	bird	noun
robot	robotti	appliance	noun
rock	kallio	nature	noun
rocker	rokkari	person	noun
rocket	raketti	vehicle	noun
rocking_chair	keinutuoli	furniture	noun
rollercoaster	vuoristorata	vehicle	noun
rollerskate	rullaluistin	sport	noun
rolling_pin	kaulin	tool	noun
rolls_royce	rolls royce	vehicle	noun
roof	katto	furniture	noun
room	huone	building	noun
rooster	kukko	bird	noun
root	juuri	plant	noun
rope	köysi	tool	noun
rose	ruusu	plant	noun
rug	matto	furniture	noun
ruler	viivoitin	tool	noun
rust	ruoste	material	noun
sack	säkki	container	noun
saddle	satula	tool	noun
sailboat	purjevene	vehicle	noun
salad	salaatti	food	noun
salamander	salamanteri	animal	noun
salmon	lohi	waterlife	noun
salt	suola	food	noun
sand	hiekka	material	noun
sandal	sandaali	clothing	noun
sandpaper	hiekkapaperi	tool	noun
sandwich	voileipä	food	noun
sardine	sardiini	waterlife	noun
satchel	olkalaukku	accessory	noun
satellite	satelliitti	vehicle	noun
satsuma	satsuma	fruit	noun
sauce	kastike	food	noun
saucer	aluslautanen	tool	noun
sausage	makkara	food	noun
saw	saha	tool	noun
saxophone	saksofoni	instrument	noun
scab	rupi	medicine	noun
scallop	kampasimpukka	waterlife	noun
scalpel	skalpelli	tool	noun
scar	arpi	medicine	noun
scarecrow	linnunpelätin	tool	noun
scarf	huivi	clothing	noun
school	koulu	building	noun
science	tiede	abstract_high	noun
scissors	sakset	tool	noun
scooter	skootteri	vehicle	noun
scorpion	skorpioni	insect	noun
screw	ruuvi	tool	noun
screwdriver	ruuvimeisseli	tool	noun
scythe	viikate	tool	noun
sea	meri	nature	noun
seagull	lokki	bird	noun
seahorse	merihevonen	waterlife	noun
seal	hylje	animal	noun
seam	sauma	abstract_low	noun
seashell	simpukankuori	artifact	noun
seat	istuin	furniture	noun
seaweed	merilevä	waterlife	noun
sedan	sedan	vehicle	noun
seed	siemen	plant	noun
sewer	viemäri	furniture	noun
shack	tönö	place	noun
shark	hai	waterlife	noun
shawl	hartiahuivi	clothing	noun
shed	vaja	place	noun
sheep	lammas	animal	noun
shell	kuori	artifact	noun
shelves	hyllykkö	furniture	noun
shield	kilpi	weapon	noun
ship	laiva	vehicle	noun
shirt	paita	clothing	noun
shoe	kenkä	clothing	noun
shoestring	kengännauha	clothing	noun
shop	myymälä	place	noun
shore	ranta	nature	noun
shotgun	haulikko	weapon	noun
shoulder	olkapää	bodypart	noun
shovel	lapio	tool	noun
shrimp	katkarapu	waterlife	noun
sidewalk	jalkakäytävä	place	noun
sign	kyltti	text	noun
size	koko	abstract_mid	noun
skate	luistin	sport	noun
skateboard	skeittilauta	sport	noun
ski	suksi	sport	noun
skillet	paistinpannu	container	noun
skin	iho	bodypart	noun
skirt	hame	clothing	noun
skull	pääkallo	bodypart	noun
skunk	haisunäätä	animal	noun
sky	taivas	nature	noun
skyscraper	pilvenpiirtäjä	place	noun
sledge	kelkka	vehicle	noun
sledgehammer	leka	tool	noun
sleeve	hiha	clothing	noun
sleigh	reki	vehicle	noun
slingshot	ritsa	toy	noun
slipper	aamutossu	clothing	noun
slope	rinne	nature	noun
slug	etana	insect	noun
slush	loska	nature	noun
snail	etana	insect	noun
snake	käärme	animal	noun
sneaker	lenkkitossu	sport	noun
snow	lumi	nature	noun
soap	saippua	material	noun
sock	sukka	clothing	noun
soda	kivennäisvesi	drink	noun
sofa	sohva	furniture	noun
soil	maaperä	nature	noun
soldier	sotilas	human	noun
song	laulu	abstract_mid	noun
soot	noki	nature	noun
soup	keitto	food	noun
spade	puutarhalapio	tool	noun
spaghetti	spagetti	food	noun
spanner	kiintoavain	tool	noun
spark	kipinä	nature	noun
sparrow	varpunen	bird	noun
spatula	lasta	tool	noun
spear	keihäs	weapon	noun
speck	tuhru	abstract_low	noun
speech	puhe	abstract_mid	noun
speedboat	pikavene	vehicle	noun
spice	mauste	food	noun
spider	hämähäkki	insect	noun
spinach	pinaatti	vegetable	noun
spirit	sielu	abstract_high	noun
sponge	pesusieni	artifact	noun
spool	kela	tool	noun
spoon	lusikka	tool	noun
squid	kalmari	waterlife	noun
squirrel	orava	animal	noun
stable	talli	building	noun
stadium	stadion	place	noun
stain	tahra	abstract_low	noun
stair	porras	building	noun
staircase	portaikko	place	noun
stapler	nitoja	tool	noun
star	tähti	nature	noun
starling	kottarainen	bird	noun
statue	patsas	building	noun
status	status	abstract_high	noun
steak	pihvi	food	noun
steam	höyry	material	noun
stem	kanta	abstract_low	noun
step	rappu	artifact	noun
stereo	stereot	appliance	noun
stew	pataruoka	food	noun
stick	keppi	nature	noun
stingray	rausku	waterlife	noun
stocking	sukkahousut	clothing	noun
stomach	vatsa	bodypart	noun
stone	kivi	nature	noun
stool	jakkara	furniture	noun
store	kauppa	place	noun
stork	kattohaikara	bird	noun
story	tarina	abstract_high	noun
stove	hella	appliance	noun
strainer	sihti	tool	noun
strait	salmi	nature	noun
straw	olki	material	noun
strawberry	mansikka	fruit	noun
stream	virta	nature	noun
street	katu	place	noun
streetlights	katuvalot	appliance	noun
string	naru	tool	noun
studio	studio	building	noun
submarine	sukellusvene	vehicle	noun
subway	metro	vehicle	noun
success	menestys	abstract_high	noun
sugar	sokeri	food	noun
suit	puku	clothing	noun
sultana	sultaanirusina	food	noun
sun	aurinko	nature	noun
sunburn	auringonpolttama	medicine	noun
sundial	aurinkokello	tool	noun
sunflower	auringonkukka	plant	noun
sunglasses	aurinkolasit	clothing	noun
sunshine	auringon paiste	abstract_low	noun
supermarket	supermarketti	place	noun
supper	illallinen	food	noun
surf	surffaus	sport	noun
surfboard	lainelauta	sport	noun
swan	joutsen	bird	noun
sweat	hiki	medicine	noun
sweater	villapaita	clothing	noun
sweatshirt	collegepaita	clothing	noun
sweet_potato	bataatti	vegetable	noun
swimsuit	uimapuku	clothing	noun
sword	miekka	tool	noun
sycamore	sykomoriviikunapuu	plant	noun
symptom	oire	abstract_mid	noun
syringe	ruisku	medicine	noun
syrup	siirappi	food	noun
system	järjestelmä	abstract_high	noun
table	pöytä	furniture	noun
tablespoon	ruokalusikka	tool	noun
tack	ommel	medicine	noun
taco	taco	food	noun
tail	häntä	body/animal	noun
tambourine	tamburiini	instrument	noun
tangerine	tangeriini	fruit	noun
tap	hana	furniture	noun
tape	teippi	tool	noun
tarantula	tarantella	insect	noun
taxi	taksi	vehicle	noun
tea	tee	drink	noun
teacher	opettaja	human	noun
team	joukkue	abstract_mid	noun
teeth	hampaat	bodypart	noun
telephone	puhelin	appliance	noun
telescope	teleskooppi	appliance	noun
television	televisio	appliance	noun
temple	temppeli	building	noun
tent	teltta	place	noun
termite	termiitti	insect	noun
textbook	oppikirja	text	noun
theater	teatteri	social	noun
thermometer	kuumemittari	appliance	noun
thigh	reisi	bodypart	noun
thimble	sormustin	tool	noun
thorn	piikki	plant	noun
thought	ajatus	abstract_high	noun
thread	ompelulanka	artifact	noun
throne	valtaistuin	furniture	noun
thumb	peukalo	bodypart	noun
thunderbolt	salama	nature	noun
ticket	pääsylippu	tool	noun
tie	solmio	clothing	noun
tiger	tiikeri	animal	noun
tights	legginsit	clothing	noun
time	ajankohta	abstract_high	noun
timing	ajoitus	abstract_high	noun
tire	rengas	artifact	noun
toad	rupikonna	animal	noun
toast	paahtoleipä	food	noun
toaster	leivänpaahdin	appliance	noun
tobacco	tupakka	food	noun
toe	varvas	bodypart	noun
toilet	vessa	place	noun
tomahawk	tomahawk	weapon	noun
tomato	tomaatti	vegetable	noun
tongs	hohtimet	tool	noun
tongue	kieli	bodypart	noun
tooth	hammas	bodypart	noun
toothbrush	hammasharja	tool	noun
toothpaste	hammastahna	medicine	noun
toothpick	hammastikku	medicine	noun
tornado	tornado	nature	noun
tortoise	kilpikonna	animal	noun
towel	pyyhe	artifact	noun
tower	torni	building	noun
toy	lelu	toy	noun
tractor	traktori	vehicle	noun
trail	polku	nature	noun
trailer	peräkärry	vehicle	noun
train	juna	vehicle	noun
trash	roska	container	noun
tray	tarjotin	tool	noun
tree	puu	plant	noun
tribe	heimo	social	noun
tricycle	kolmipyöräinen	vehicle	noun
tripod	tripodi	tool	noun
trolley	kärryt	vehicle	noun
trombone	pasuuna	instrument	noun
trophy	pokaali	artifact	noun
trousers	housut	clothing	noun
trout	taimen	waterlife	noun
trowel	laastilapio	tool	noun
truck	rekka	vehicle	noun
trumpet	trumpetti	instrument	noun
t-shirt	t-paita	clothing	noun
tuba	tuuba	instrument	noun
tugboat	hinaaja	vehicle	noun
tulip	tulppaani	plant	noun
tuna	tonnikala	waterlife	noun
tunnel	tunneli	place	noun
turnip	nauris	vegetable	noun
turtle	merikilpikonna	animal	noun
tweezers	pinsetit	tool	noun
twig	risu	nature	noun
typewriter	kirjoituskone	appliance	noun
umbrella	sateenvarjo	artifact	noun
underwear	alusvaate	clothing	noun
unicorn	yksisarvinen	abstract_low	noun
unicycle	yksipyöräinen	vehicle	noun
uniform	univormu	clothing	noun
university	yliopisto	abstract_high	noun
town	taajama	abstract_mid	noun
urinal	pisoaari	furniture	noun
urn	uurna	container	noun
utensil	työväline	tool	noun
vacuum	tyhjiö	abstract_high	noun
valium	valium	medicine	noun
valley	laakso	nature	noun
van	pakettiauto	vehicle	noun
vase	vaasi	container	noun
vegetable	kasvis	vegetable	noun
veil	huntu	clothing	noun
vein	laskimo	bodypart	noun
vest	liivi	clothing	noun
village	kylä	building	noun
vine	köynnös	plant	noun
violin	viulu	instrument	noun
volcano	tulivuori	nature	noun
volleyball	lentopallo	sport	noun
vulture	haaskalintu	bird	noun
wagon	vankkuri	vehicle	noun
waist	vyötärö	bodypart	noun
wall	muuri	building	noun
wallet	lompakko	accessory	noun
wallpaper	tapetti	furniture	noun
walnut	saksanpähkinä	fruit	noun
walrus	mursu	animal	noun
wand	sauva	tool	noun
wart	syylä	medicine	noun
washing machine	pesukone	furniture	noun
wasp	ampiainen	insect	noun
water	vesi	nature	noun
watermelon	vesimeloni	fruit	noun
wave	aalto	nature	noun
wax	vaha	material	noun
wedding	häät	social	noun
weed	rikkaruoho	plant	noun
weight	paino	abstract_mid	noun
wetsuit	märkäpuku	clothing	noun
whale	valas	waterlife	noun
wheat	vehnä	food	noun
wheel	pyörä	tool	noun
wheelbarrow	kottikärryt	vehicle	noun
wheelchair	pyörätuoli	vehicle	noun
whip	piiska	tool	noun
whisk	vispilä	tool	noun
whisker	viiksi	bodypart	noun
whisky	viski	drink	noun
whistle	pilli	instrument	noun
whiteboard	valkotaulu	furniture	noun
wife	vaimo	human	noun
wig	peruukki	accessory	noun
will	tahto	abstract_high	noun
willow	paju	plant	noun
wind	tuuli	nature	noun
windmill	tuulimylly	place	noun
window	ikkuna	furniture	noun
windshield	tuulilasi	artifact	noun
wine	viini	drink	noun
wing	siipi	body/animal	noun
wire	johto	appliance	noun
wolf	susi	animal	noun
woman	nainen	human	noun
womb	kohtu	bodypart	noun
wood	polttopuu	material	noun
wool	villa	material	noun
work	teos	abstract_mid	noun
world	maailma	nature	noun
worm	mato	insect	noun
wreckage	hylky	place	noun
wren	peukaloinen	bird	noun
wrench	jakoavain	tool	noun
yacht	huvialus	vehicle	noun
yak	jakki	animal	noun
yam	jamssi	vegetable	noun
yard	jaardi	abstract_high	noun
yarn	lanka	artifact	noun
yogurt	jogurtti	food	noun
yoke	ies	tool	noun
youth	nuoruus	abstract_high	noun
yoyo	jojo	sport	noun
zebra	seepra	animal	noun
zipper	vetoketju	tool	noun
zoo	eläintarha	place	noun
