eng_name	fin_name	category	word_class
accept	hyväksyä	exchange	noun
ache	särky	action	noun
ache	särkeä	Body-sense	verb
acquire	hankkia	exchange	noun
admit	myöntää	action	noun
advice	neuvoa	action	noun
airplane	lentokone	vehicle	noun
ankle	nilkka	bodypart	noun
apple	omena	fruit	noun
approach	lähestymistapa	action	noun
approach	lähestyä	Motion-direction	noun
argue	väitellä	action	noun
arm	käsivarsi	bodypart	noun
arrival	saapuminen	action	noun
arrive	saapua	Motion-direction	noun
artichoke	artisokka	vegetable	noun
ascend	nousta	Motion-direction	noun
ascent	nousu	action	noun
ask	kysyä	action	noun
asparagus	parsa	vegetable	noun
aubergine	munakoiso	vegetable	noun
axe	kirves	tool	noun
bake	leipoa	cooking	verb
banana	banaani	fruit	noun
bark	haukkua	Noise-animal	verb
beak	nokka	bodypart	noun
bean	papu	vegetable	noun
bear	karhu	animal	noun
belt	vyö	clothing	noun
bend	taipua	Change-state	verb
bicycle	polkupyörä	vehicle	noun
bird	lintu	bird	noun
bleed	vuotaa verta	action	verb
blend 	sekoittua	Change-state	noun
blink	silmänräpäys	action	noun
blink	räpäyttää	Body-action	verb
blouse	pusero	clothing	noun
boat	vene	vehicle	noun
boil	kiehua	cooking	verb
bomb	pommi	weapon	noun
bomb	pommittaa	action	verb
bombardment	pommitus	abstract_low	noun
book	kirja	tool	noun
borrow	lainata	action	verb
bounce	pomppia	action	verb
box	laatikko	container	noun
break	rikkoa	action	verb
breathe	hengittää	action	verb
broccoli	parsakaali	vegetable	noun
broom	luuta	tool	noun
brush	harja	tool	noun
brush	harjata	action	verb
build 	rakentaa	action	verb
bump 	törmätä	action	verb
burn 	palaa	nature	verb
burp	röyhtäys	action	noun
burp	röyhtäistä	Body-action	verb
bus	bussi	vehicle	noun
buy	ostaa	action	verb
cabbage	kaali	vegetable	noun
call	soittaa	action	verb
call	kutsu	abstract_low	noun
camel	kameli	animal	noun
car	auto	vehicle	noun
carpet	kokolattiamatto	furniture	noun
carrot	porkkana	vegetable	noun
carry	kantaa	action	verb
cat	kissa	animal	noun
cauliflower	kukkakaali	vegetable	noun
ceiling	sisäkatto	furniture	noun
celery	selleri	vegetable	noun
chair	tuoli	furniture	noun
challenge	haaste	action	noun
chase	jahdata	action	verb
chat	jutella	action	verb
chat	keskustelu	action	noun
cherry	kirsikka	fruit	noun
chime	kello	artifact	noun
chime	soida	action	verb
chin	leuka	bodypart	noun
chirp	visertää	action	verb
chirp	viserrys	action	noun
chisel	taltta	tool	noun
chop	pilkkoa	action	verb
clang	helähdys	action	noun
clang	kilauttaa	action	verb
clash	yhteenotto	action	noun
clatter	kolista	action	verb
clatter	kolina	action	noun
coat	takki	clothing	noun
comb	kampa	tool	noun
come	tulla	action	verb
command	käsky	action	noun
command	käskeä	action	verb
construct	rakentaa	action	verb
construction	rakennelma	place	noun
cook	laittaa ruokaa	cooking	verb
corn	maissi	vegetable	noun
couch	sohva	furniture	noun
cough	yskiä	action	verb
cough	yskä	action	noun
cow	lehmä	animal	noun
crackle	rätistä	action	verb
crackle	rätinä	action	noun
crash	törmätä	action	verb
crash	törmäys	action	noun
creep	hiipiä	action	verb
crowbar	sorkkarauta	tool	noun
cry	itkeä	action	verb
cry	itku	action	noun
cucumber	kurkku	vegetable	noun
curtains	verhot	furniture	noun
cut	leikata	action	noun
dagger	tikari	weapon	noun
demand	vaatimus	abstract_high	noun
demand	vaatia	action	verb
descend	laskeutua	action	verb
descent	laskeutuminen	action	noun
destroy	tuhota	action	verb
destruction	tuhoaminen	action	noun
die	kuolla	action	verb
dive	sukeltaa	action	verb
dog	koira	animal	noun
donate	lahjoittaa	action	verb
donation	lahjoitus	abstract_high	noun
donkey	aasi	animal	noun
door	ovi	furniture	noun
doorknob	ovenkahva	artifact	noun
drag 	raahata	action	verb
draw	piirtää	action	verb
dress	mekko	clothing	noun
drill	pora	tool	noun
drill	porata	action	verb
drink	juoda	action	verb
drive	ajaa	action	verb
drool	kuolata	action	verb
drop	tiputtaa	action	verb
duck	ankka	animal	noun
dustpan	rikkalapio	tool	noun
ear	korva	bodypart	noun
eat	syödä	action	verb
eject	heittää ulos	action	verb
elbow	kyynärpää	bodypart	noun
elephant	norsu	animal	noun
empty	tyhjentää	action	verb
enter	mennä sisään	action	verb
entry	sisääntulo	abstract_low	noun
escape	pako	action	noun
escape	paeta	action	verb
exchange	vaihtaa	action	verb
exchange	vaihtokauppa	action	noun
eye	silmä	bodypart	noun
face	kasvot	bodypart	noun
fall	pudota	action	verb
feather	höyhen	material	noun
feel	tuntea	action	verb
fence	aita	building	noun
file	tiedosto	artifact	noun
fill	täyttää	action	verb
find	löytää	action	verb
finger	sormi	bodypart	noun
fish	kala	waterlife	noun
fix	korjata	action	verb
flame	liekki	nature	noun
flame	liekehtiä	action	verb
flash 	väläyttää	action	verb
flicker	lepatus	action	noun
flicker	lepattaa	action	verb
floor	lattia	furniture	noun
flying	lentää	action	verb
follow	seurata	action	verb
fork	haarukka	tool	noun
fox	kettu	animal	noun
frown	kurtistaa kulmiaan	action	verb
frown	kurtistus	action	noun
fry	paistaa	action	verb
fur	turkki	clothing	noun
gate	portti	building	noun
get	saada	action	verb
giraffe	kirahvi	animal	noun
give	antaa	action	verb
glove	käsine	clothing	noun
glow	loistaa	action	verb
glow	loiste	action	noun
go 	mennä	action	verb
goat	vuohi	animal	noun
grape	viinirypäle	fruit	noun
grapefruit	greippi	fruit	noun
greet 	tervehtiä	action	verb
grill	grillata	action	verb
grin	virnistää	action	verb
growl	murina	action	noun
growl	murista	action	verb
gun	ase	weapon	noun
hair	hiukset	bodypart	noun
halt	pysähtyä	action	verb
hammer	vasara	tool	noun
hammer	vasaroida	action	verb
hand	käsi	bodypart	noun
hat	hattu	clothing	noun
hatchet	retkikirves	tool	noun
head	pää	bodypart	noun
hear 	kuulla	action	verb
helicopter	helikopteri	vehicle	noun
hiccup	hikka	action	noun
hiccup	nikotella	action	verb
hit	lyödä	action	verb
hit	isku	action	noun
hoe	kuokka	tool	noun
hoe	kuokkia	action	verb
hold	pidellä	action	verb
hop	hyppiä	action	verb
horse	hevonen	animal	noun
inhale	hengittää sisään	action	verb
inject	ruiskuttaa	action	verb
invite	kutsua	action	verb
itch	kutina	action	noun
itch	kutista	action	verb
jog	hölkätä	action	verb
kick	potkaista	action	verb
kill	tappaa	action	verb
knee	polvi	bodypart	noun
knife	veitsi	tool	noun
knock	koputtaa	action	verb
knock	koputus	action	noun
lead	johtaa	action	verb
leave	jättää	action	verb
leg	jalka	bodypart	noun
lemon	sitruuna	fruit	noun
lend	lainata	action	verb
leopard	leopardi	animal	noun
lettuce	lehtisalaatti	vegetable	noun
lick	nuolla	action	verb
lift	nostaa	action	verb
lime	lime	fruit	noun
limp	ontua	action	verb
lion	leijona	animal	noun
lip	huuli	bodypart	noun
listen	kuunnella	action	verb
loan	laina 	action	noun
loan	lainata	action	verb
look	katsella	action	noun
lose	menettää	action	verb
loss	menetys	action	noun
make	tehdä	action	verb
march	marssia	action	verb
meow	naukua	action	verb
meow	naukuminen	action	noun
mitten	tumppu	clothing	noun
mix 	sekoittaa	action	verb
motorcycle	moottoripyörä	vehicle	noun
mouse_computer	tietokonehiiri	appliance	noun
mouth	suu	bodypart	noun
move	liikkua	action	verb
murder	murhata	action	verb
murder	murha 	action	noun
mushroom	sieni	vegetable	noun
neck	kaula	bodypart	noun
nose	nenä	bodypart	noun
notice	huomata	action	verb
oink	röhkiä	action	verb
oink	röhkäisy	action	noun
onion	sipuli	vegetable	noun
orange	appelsiini	fruit	noun
paint	maalata	action	verb
paw 	tassu	bodypart	noun
pay	maksaa	action	verb
pea	herne	vegetable	noun
peach	persikka	fruit	noun
pear	päärynä	fruit	noun
pedal	polkea	action	verb
pen	kynä	tool	noun
pencil	lyijykynä	tool	noun
pepper	pippuri	food	noun
pig	sika	animal	noun
pineapple	ananas	fruit	noun
place	asettaa	action	verb
plea	pyyntö	action	noun
plead	pyytää	action	verb
pliers	pihdit	tool	noun
plum	luumu	fruit	noun
potato	peruna	vegetable	noun
pound	hakata	action	verb
pour	kaataa	action	verb
preach	saarnata	action	verb
press	painaa	action	verb
pull	veto	action	noun
pull	vetää	action	verb
pumpkin	kurpitsa	vegetable	noun
punch	lyödä	action	verb
push	työntö	action	noun
push	työntää	action	verb
put	asettaa	action	verb
rabbit	kani	animal	noun
raft	lautta	vehicle	noun
raisin	rusina	food	noun
rake	harava	tool	noun
rake	haravoida	action	verb
raspberry	vadelma	fruit	noun
rattle	ravistella	action	verb
razor	partahöylä	tool	noun
read	lukea	action	verb
receive	vastaanottaa	action	verb
repair	korjata	action	verb
repair	korjaus	action	noun
request	pyytää	action	verb
request	pyyntö	action	noun
retch	oksentaa	action	noun
return	palautus	action	noun
return	palauttaa	action	verb
ride	ratsastaa	action	verb
rise	nousta	action	verb
roast	paahtaa	action	verb
roof	katto	furniture	noun
rug	matto	furniture	noun
run	juosta	action	verb
saw	saha	tool	noun
saw	sahata	action	verb
say	sanoa	action	verb
scarf	huivi	clothing	noun
scissors	sakset	tool	noun
scream	kirkaisu	action	noun
scream	kirkua	action	verb
screech	kirskua	action	verb
screech	kirskunta	action	noun
screwdriver	ruuvimeisseli	tool	noun
seat	istuin	furniture	noun
see 	nähdä	action	verb
sell	myydä	action	verb
send	lähettää	action	verb
sense	tuntea	action	verb
shake	ravistaa	action	verb
shave	sheivata	action	verb
sheep	lammas	animal	noun
shield	kilpi	weapon	noun
shine	loiste	action	noun
shine	loistaa	action	verb
ship	laiva	vehicle	noun
shirt	paita	clothing	noun
shoe	kenkä	clothing	noun
shoulder	olkapää	bodypart	noun
shout	huutaa	action	verb
shout	huuto	action	noun
shovel	lapio	tool	noun
shovel	lapioida	action	noun
sigh	huokaus	action	noun
sigh	huokaista	action	verb
sing	laulaa	action	verb
sink	upota	action	verb
sit	istua	action	verb
skid	liukua	action	verb
skirt	hame	clothing	noun
slap	läpsäistä	action	verb
slide	liukua	action	verb
smash	murskata	action	verb
smile	hymyillä	action	verb
smoke	tupakoida	action	verb
sneeze	aivastaa	action	verb
snore	kuorsata	action	verb
sock	sukka	clothing	noun
spit	sylkeä	action	verb
spoon	lusikka	tool	noun
stop	pysähtyä	action	verb
strawberry	mansikka	fruit	noun
swan	joutsen	bird	noun
sweater	villapaita	clothing	noun
swim	uida	action	verb
sword	miekka	tool	noun
talk	puhua	action	verb
taste	maistaa	action	verb
teeth	hampaat	bodypart	noun
throw	heittää	action	verb
thumb	peukalo	bodypart	noun
tickle	kutittaa	action	verb
tiger	tiikeri	animal	noun
toe	varvas	bodypart	noun
toothbrush	hammasharja	tool	noun
touch	koskettaa	action	verb
train	juna	vehicle	noun
tricycle	kolmipyöräinen	vehicle	noun
trousers	housut	clothing	noun
truck	rekka	vehicle	noun
tweezers	pinsetit	tool	noun
van	pakettiauto	vehicle	noun
vest	liivi	clothing	noun
wade	kahlata	action	verb
walk	kävellä	action	verb
wash	pestä	action	verb
watch	katsoa	action	verb
watermelon	vesimeloni	fruit	noun
wink	iskeä silmää	action	verb
wrench	jakoavain	tool	noun
write	kirjoittaa	action	verb
yawn	haukotella	action	verb
zebra	seepra	animal	noun
